100000000000000
000000000000000
000000000001000
000000000001000
000000000001000
011111100000000
000000000000000
000000000000000
000000001000011
000000000000000
000000000000000
000000000000000
000000000000000
000000000011100
001000000000100
001000000000000
001000000000000
001000000000000
000000000000000
000000000000000